tilemap
10 10
1 0 0 0 0 0 0 0 0 0
1 0 2 0 0 0 0 0 0 0
1 0 0 0 0 0 0 0 0 0
1 0 0 0 0 4 4 0 0 0
1 0 0 0 0 1 4 0 0 0
1 0 0 3 0 4 4 0 0 0
1 0 0 0 0 0 0 0 0 0
1 0 0 0 0 0 9 0 0 0
1 0 2 0 0 0 0 0 0 0
1 0 0 0 0 0 0 6 0 0
scale 2.5
wildness 1.0
