tilemap
11 11
1 1 1 1 1 1 1 1 1 1 1
1 3 0 0 0 0 0 0 0 0 1
1 0 0 11 0 0 0 11 0 0 1
1 11 0 0 11 0 0 11 0 0 1
1 0 0 0 0 0 0 0 0 0 1
1 0 0 11 0 0 11 0 0 11 1
1 0 11 0 0 0 11 0 0 0 1
1 11 0 0 11 0 0 11 0 0 1
1 0 0 11 0 11 0 0 0 0 1
1 0 0 0 0 0 0 0 0 2 1
1 1 1 1 1 1 1 1 1 1 1
scale 2.5
wildness 0.0
next level4.txt