tilemap
12 10
1 1 1 1 1 1 1 1 1 1 1 1
1 3 0 0 0 0 0 0 0 0 0 1
1 0 1 1 1 1 1 1 0 1 0 1
1 0 1 0 0 0 0 1 0 1 0 1
1 0 1 0 1 1 0 1 0 1 0 1
1 0 1 0 1 1 0 1 0 1 0 1
1 0 0 0 0 0 0 0 0 1 0 1
1 1 1 1 1 1 1 1 1 1 0 1
1 0 0 0 0 0 0 0 0 0 2 1
1 1 1 1 1 1 1 1 1 1 1 1
scale 2.5
wildness 0.4
next level3.txt