tilemap
10 5
1 1 1 1 1 1 1 1 1 1
1 3 0 0 4 0 0 4 0 1
1 1 1 0 4 0 0 4 2 1
1 0 0 0 4 0 0 4 0 1
1 1 1 1 1 1 1 1 1 1
scale 3.0
wildness 0.0
next level2.txt
