tilemap
12 8
1 1 0 1 1 1 1 1 1 1 1 1
1 3 0 0 0 0 0 0 0 0 0 1
1 0 0 0 0 0 0 0 0 0 0 1
1 0 0 0 0 0 0 0 0 0 0 1
1 0 0 0 0 0 0 0 0 0 0 1
1 0 0 0 0 0 0 0 0 0 0 1
1 0 7 0 0 0 0 0 0 0 2 1
1 11 0 0 1 1 1 1 1 1 1 1
scale 2.5
wildness 0.0
next level6.txt