tilemap
15 9
1 1 1 1 1 1 1 1 1 1 1 1 1 1 1
1 3 6 4 4 4 0 4 4 4 4 0 4 2 1
1 1 4 4 4 4 4 4 4 4 4 4 4 1 1
1 4 0 4 4 0 4 4 4 0 4 4 4 4 1
1 4 4 4 4 4 4 4 4 4 4 0 4 0 1
1 4 0 4 4 0 0 4 4 4 4 4 4 4 1
1 4 4 4 4 4 4 4 4 4 4 4 4 4 1
1 4 0 0 4 4 4 4 0 4 4 0 4 4 1
1 1 1 1 1 1 1 1 1 1 1 1 1 1 1
scale 2.5
wildness 0.0
power 3
msg_title VOID_WALKER
msg_body Watch_your_step._Maximum_jump_range_is_3.
next level14.txt
