tilemap
12 11
1 1 1 1 1 1 1 1 1 1 1 1
1 3 0 6 0 0 0 0 0 0 0 1
1 0 0 0 0 0 0 0 0 0 0 1
1 11 0 0 11 0 0 11 0 0 0 1
1 0 0 0 0 0 0 0 0 0 0 1
1 0 0 12 0 0 12 0 0 12 0 1
1 0 0 0 0 0 0 0 0 0 0 1
1 13 0 0 13 0 0 13 0 0 0 1
1 0 0 0 0 0 0 0 0 0 0 1
1 0 0 0 0 0 0 0 0 0 2 1
1 1 1 1 1 1 1 1 1 1 1 1
scale 2.2
wildness 0.0
power 3
msg_title TRAFFIC_AHEAD
msg_body Orange_moves_Horizontal._Green_moves_Vertical.
next level4.txt