tilemap
15 15
1 1 1 1 1 1 1 1 1 1 1 1 1 1 1
1 3 0 0 0 0 0 0 0 0 0 0 0 0 1
1 0 1 9 0 0 0 0 0 0 0 10 1 0 1
1 0 8 0 0 0 0 0 0 0 0 0 8 0 1
1 0 0 0 0 0 0 14 0 0 0 0 0 0 1
1 0 0 0 0 13 0 0 0 11 0 0 0 0 1
1 0 0 0 0 0 0 0 0 0 0 0 0 0 1
1 0 0 0 0 0 0 4 0 0 0 0 0 0 1
1 0 0 0 0 0 0 0 0 0 0 0 0 0 1
1 0 0 0 0 13 0 0 0 11 0 0 0 0 1
1 0 0 0 0 0 0 12 0 0 0 0 0 0 1
1 0 7 0 0 0 0 0 0 0 0 0 7 0 1
1 0 1 9 0 0 0 0 0 0 0 10 1 0 1
1 0 0 0 0 0 0 0 0 0 0 0 0 2 1
1 1 1 1 1 1 1 1 1 1 1 1 1 1 1
scale 2.0
wildness 0.5
next level9.txt