tilemap
12 9
1 1 1 1 1 1 1 1 1 1 1 1
1 3 0 0 0 0 10 4 0 4 2 1
1 1 1 1 1 0 10 4 0 4 4 1
1 4 4 4 4 4 10 4 0 4 4 1
1 4 4 4 4 4 10 4 0 4 0 1
1 4 4 4 4 4 1 0 1 1 1 1
1 4 4 4 4 4 4 0 4 4 4 1
1 4 4 4 4 4 4 7 4 4 4 1
1 1 1 1 1 1 1 11 1 1 1 1
scale 2.5
wildness 0.0
power 3
msg_title THE_ARCHITECT
msg_body Gates_can_overwrite_the_void._Wait_for_the_bridge.
next level15.txt
