tilemap
12 12
1 1 1 1 1 1 1 1 1 1 1 1
1 0 0 0 0 0 0 0 0 0 3 1
1 0 0 0 0 0 0 0 0 0 0 12
0 0 0 0 0 0 0 0 0 0 10 0
0 0 1 0 0 0 0 0 0 0 0 0
0 9 0 0 0 0 0 0 0 0 0 1
0 0 0 0 0 0 0 0 0 1 0 0
1 0 0 0 0 0 0 0 0 0 10 0
0 0 1 0 0 0 0 0 0 0 0 0
0 9 0 0 0 0 0 0 0 0 0 1
0 0 0 0 0 0 0 0 0 0 2 1
1 1 1 1 1 1 1 1 1 1 1 1
scale 2.2
wildness 0.1
next level7.txt