tilemap
12 12
1 1 1 1 1 1 1 1 1 1 1 1
1 3 6 0 0 0 0 0 0 0 0 1
1 12 0 0 0 0 0 0 0 0 0 1
1 0 9 0 0 0 0 0 0 0 0 1
1 0 0 0 0 0 0 0 0 0 0 1
1 12 0 8 8 8 8 8 8 8 8 1
1 0 0 0 0 0 0 0 0 0 0 1
1 0 0 0 0 0 0 0 0 0 0 1
1 1 0 0 0 0 0 0 0 0 0 1
1 0 0 0 0 0 0 0 0 0 0 1
1 0 0 0 0 0 0 0 0 0 2 1
1 1 1 1 1 1 1 1 1 1 1 1
scale 2.2
wildness 0.0
power 4
msg_title PRODUCTION_LINE
msg_body The_gates_are_printing_moving_hazards.
next level13.txt
