tilemap
8 8
3 0 0 1 0 0 4 4
0 0 0 1 0 4 4 4
4 4 4 4 4 4 4 0
4 4 4 4 4 4 0 0
4 4 4 4 4 4 1 1
4 4 4 4 4 4 0 0
0 0 4 4 4 4 0 0
2 0 4 4 4 0 0 0
scale 2.2
wildness 1.0
power 5
next level11.txt
