tilemap
15 15
1 1 1 1 1 1 1 1 1 1 1 1 1 1 1
1 3 0 0 0 0 0 0 0 0 0 0 0 0 1
1 0 0 1 0 0 0 0 0 0 0 1 0 0 1
1 0 1 0 0 0 11 0 11 0 0 0 1 0 1
1 0 0 0 0 0 0 0 0 0 0 0 0 0 1
1 0 0 0 0 0 0 0 0 0 0 0 0 0 1
1 0 0 12 0 0 0 0 0 0 0 12 0 0 1
1 0 0 0 0 0 0 4 0 0 0 0 0 0 1
1 0 0 12 0 0 0 0 0 0 0 12 0 0 1
1 0 0 0 0 0 0 0 0 0 0 0 0 0 1
1 0 0 0 0 0 0 0 0 0 0 0 0 0 1
1 0 1 0 0 0 11 0 11 0 0 0 1 0 1
1 0 0 1 0 0 0 0 0 0 0 1 0 0 1
1 0 0 0 0 0 0 0 0 0 0 0 0 2 1
1 1 1 1 1 1 1 1 1 1 1 1 1 1 1
scale 2.0
wildness 1.5